{
    "width": 31,
    "height": 13,
    "playerY": 6,
    "playerX": 15,
    "map": [
    "■■■■■■■■■■■■■■■#■■■■■■■■■■■■■■■",
    "■.............................■",
    "■.............................■",
    "■.............................■",
    "■.............................■",
    "■.............................■",
    "■.....x.......................■",
    "■.............................■",
    "■.............................■",
    "■.............................■",
    "■.............................■",
    "■.............................■",
    "■■■■■■■■■■■■■■■■■■■■■■■■■■■■■■■"
    ],
    "doors": [
        {
            "x": 15,
            "y": 0,
            "target": 1,
            "targetX": 16,
            "targetY": 6
        }
    ]
}